11111111111111111111111111
10000000000000000000000001
1000000000000P0E0C00000001
10001000000000000000000001
10001000000000000000000001
10001000000000000000000001
11111111111111111111111111
