11111111111111111111111111
10000000000000001000000001
100CCCCCCC0000E01C00000001
100010000P0000001000000001
10001000000000000000000001
10001000000000000000000001
10001111111000000000000001
10000000000000001D00000001
10000000000000001000000001
11111111111111111111111111